000000000000000
000000000000000
000011000110000
000011001110000
000011011100000
000011111000000
000011110000000
000011411000000
000011112100000
000011013110000
000011001110000
000011000110000
000000000000000
000000000000000
000000000000000

levelc-1.png
None set