00000000000
01111111110
01111111110
01110000000
01111111110
01111111110
01110000000
01110000000
01112311110
01111411110
00000000000

level1-1.png
21