00000000000000000000000000000000
00000000000000000000000000000000
00000000000000000000000000000000
00000000000000000000000000000000
00000000000301111000000000000000
00000000000301001000000000000000
00000000000301211121000000000000
00000000000301010101000000000000
00000000000301010101000000000000
00000000000111010111000000000000
00000000000121210121000000000000
00000000000111041100000000000000
00000000000000000000000000000000
00000000000000000000000000000000
00000000000000000000000000000000
00000000000000000000000000000000
00000000000000000000000000000000
00000000000000000000000000000000

level3-1.png
251 71136
