000000000000000
000000000000000
000011111110000
000111111111000
000111111111000
001111111111110
011110111011110
011100411001110
011100111001110
011000111000110
011000121000110
011000131000110
011000111000110
000000000000000
000000000000000

levelc-5.png
4 1088
