00000000000000000000000000000000
00000000000000000000000000000000
00000000000111100000000000000000
00000000000100111000000000000000
00000000000111111000000000000000
00000000000100121000000000000000
00000000000301212103000000000000
00000000000301121103000000000000
00000000000301212103000000000000
00000000000301121103000000000000
00000000000301212103000000000000
00000000000000121001000000000000
00000000000000141111000000000000
00000000000000001001000000000000
00000000000000001111000000000000
00000000000000000000000000000000
00000000000000000000000000000000
00000000000000000000000000000000

level3-2.png
385 98976
