00000000000000000000000000000000
00000000000000000000000000000000
00000000000000000000000000000000
00000000000311000000000000000000
00000000000124000000000000000000
00000000000310000000000000000000
00000000000010000000000000000000
00000000001212121211100000000000
00000000001111112111100000000000
00000000001000000010000000000000
00000000003111211133000000000000
00000000000000000133000000000000
00000000000000000000000000000000
00000000000000000000000000000000
00000000000000000000000000000000
00000000000000000000000000000000
00000000000000000000000000000000
00000000000000000000000000000000

level2-5.png
330 143248
