000000000000000
001111111111100
001111111111100
000000111000000
000000111000000
000000111000000
000000111000000
000000411000000
000000111000000
000000111000000
001111111111100
001111121111100
001111131111100
000000000000000
000000000000000

levelc-2.png
5 1168
