00000000000000000000000000000000
00000000000000000000000000000000
00000000000000000000000000000000
00000000000000000000000000000000
00000000000131011000000000000000
00000000000132012011100000000000
00000000000031011133300000000000
00000000000012012000000000000000
00000000000011011000000000000000
00000000000012012000000000000000
00000000000011111000000000000000
00000000000041011000000000000000
00000000000011011000000000000000
00000000000000000000000000000000
00000000000000000000000000000000
00000000000000000000000000000000
00000000000000000000000000000000
00000000000000000000000000000000

level2-6.png
916 372048
