00000000000000000000000000000000
00000000000000011000000000000000
00000000000000021000000000000000
00000000000011111111000000000000
00000000000010030001000000000000
00000000000010000001000000000000
00000000000014321001000000000000
00000000000000011001000000000000
00000000111003011001000000000000
00000000101111111001000000000000
00000012111012000001000000000000
00000010003011011123000000000000
00000011100000011110000000000000
00000011123111110000000000000000
00000000000000000000000000000000
00000000000000000000000000000000
00000000000000000000000000000000
00000000000000000000000000000000

levelc-4.png
82 22112
