00000000000000000000000000000000
00000000000000000000000000000000
00000000000000111000000000000000
00000000000001212100000000000000
00000000000111010111000000000000
00000000001111111111100000000000
00000000012011333102110000000000
00000000011111343111110000000000
00000000011201333110210000000000
00000000001111111111100000000000
00000000000111010111000000000000
00000000000001212100000000000000
00000000000000111000000000000000
00000000000000000000000000000000
00000000000000000000000000000000
00000000000000000000000000000000
00000000000000000000000000000000
00000000000000000000000000000000

levelc-2.png
485 228480
