00000000000000000000000000000000
00000000000000000000000000000000
00000000000000000000000000000000
00000000000000000000000000000000
00000000000000140111000000000000
00000000000000121121000000000000
00000000000000210000000000000000
00000000000000120111110000000000
00000000000003131311110000000000
00000000000003110000000000000000
00000000000000000000000000000000
00000000000000000000000000000000
00000000000000000000000000000000
00000000000000000000000000000000
00000000000000000000000000000000
00000000000000000000000000000000
00000000000000000000000000000000
00000000000000000000000000000000

level2-3.png
185 152640
