00000000000000000000000000000000
00000000000000000000000000000000
00000000000001110100000000000000
00000000000001112110000000000000
00000000000001102410000000000000
00000000000001112111000000000000
00000000000301100121000000000000
00000000033301221111000000000000
00000000033311211111000000000000
00000000033311011220000000000000
00000000001012011110000000000000
00000000001011111100000000000000
00000000001010000000000000000000
00000000001110000000000000000000
00000000000000000000000000000000
00000000000000000000000000000000
00000000000000000000000000000000
00000000000000000000000000000000

level3-3.png
385 98976