00000000000000000000000000000000
00000000000000000000000000000000
00000000000000000111000000000000
00000000000000000111000000000000
00000000000000000111000000000000
00000000000011000020000000000000
00000000000011111111111000000000
00000000000013001010031000000000
00000000000011111111111000000000
00000000000000002000011000000000
00000000000000011100000000000000
00000000000000014100000000000000
00000000000000011100000000000000
00000000000000000000000000000000
00000000000000000000000000000000
00000000000000000000000000000000
00000000000000000000000000000000
00000000000000000000000000000000

level1-5.png
70 22032
