000000000000000
000000000000000
000001111100000
000011000000000
000011000000000
000011431000000
000000021000000
000000001100000
000001111100000
000011111000000
000000000000000
000000000000000
000000000000000
000000000000000
000000000000000

level1-1.png
None set