000000000000000
000000000000000
000001110000000
000010011000000
000000011000000
000001430000000
000000020000000
000000011000000
000011111000000
000001110000000
000000000000000
000000000000000
000000000000000
000000000000000
000000000000000

level1-1.png
None set