00000000000000000000000000000000
00000000000000000000000000000000
00000000000000111110000000000000
00000000033300101010000000000000
00000000031111111110000000000000
00000000031111111000000000000000
00000000000102001111111000000000
00000001110111101110121000000000
00000001212122121110211000000000
00000001210111101111111000000000
00000001110020100000000000000000
00000000011010113000000000000000
00000001111111113000000000000000
00000001040100333000000000000000
00000001111100000000000000000000
00000000000000000000000000000000
00000000000000000000000000000000
00000000000000000000000000000000

levelc-1.png
384 93776
