00000000000000000000000000000000
00000000000000000000000000000000
00000000000000000000000000000000
00000000000000000000000000000000
00000000000000000000000000000000
00000000001111110110000000000000
00000000011031110110000000000000
00000000011111130110000000000000
00000000002200400220000000000000
00000000001103111111000000000000
00000000001101113011000000000000
00000000001101111110000000000000
00000000000000000000000000000000
00000000000000000000000000000000
00000000000000000000000000000000
00000000000000000000000000000000
00000000000000000000000000000000
00000000000000000000000000000000

levelc-6.png
None