000000000000000
000000000000000
000110001130000
000110011110000
000110111100000
000111111000000
000111110000000
000114100000000
000111110000000
000110111000000
000110111110000
000110011210000
000110001110000
000000000000000
000000000000000

levelc-1.png
53 13536
