00000000000
00011111000
00100100100
00100100100
00100300100
01000400010
01000200010
01000100010
01000100010
01000100010
00000000000

level1-1.png
21