00000000000000000000000000000000
00000000000000011000000000000000
00000000000000011000000000000000
00000000000000011100000000000000
00000000000000101110000000000000
00000000000000101110000000000000
00000000000000101111000000000000
00000000000000111011000000000000
00000000000000111011000000000000
00000000000000131110000000000000
00000000000000111100000000000000
00000000000001141100000000000000
00000000000002111100000000000000
00000000000001101100000000000000
00000000000000000000000000000000
00000000000000000000000000000000
00000000000000000000000000000000
00000000000000000000000000000000

levelc-5.png
None