00000000000000000000000000000000
00000000000000000000000000000000
00000000000001111100000000000000
00000000000001111100000000000000
00000000000001111100000000000000
00000000000001030100000000000000
00000000011112313211110000000000
00000000011101020101110000000000
00000000011131242131110000000000
00000000011101020101110000000000
00000000011112313211110000000000
00000000000001030100000000000000
00000000000001111100000000000000
00000000000001111100000000000000
00000000000001111100000000000000
00000000000000000000000000000000
00000000000000000000000000000000
00000000000000000000000000000000

levelc-3.png
140 64496
