000000000000000
000000000000000
000001110000000
000011010000000
000010010000000
000011431100000
000000020000000
000000010000000
000000010000000
000000010000000
000000000000000
000000000000000
000000000000000
000000000000000
000000000000000

level1-1.png
None set