00000000000000000000000000000000
00000000000000000000000000000000
00000000000000111000000000000000
00000000000001121000000000000000
00000000000011202000000000000000
00000000000112131000000000000000
00000000001121333111100000000000
00000000001203343302100000000000
00000000001111333121100000000000
00000000001111131211000000000000
00000000000000202110000000000000
00000000000000121100000000000000
00000000000000111000000000000000
00000000000000000000000000000000
00000000000000000000000000000000
00000000000000000000000000000000
00000000000000000000000000000000
00000000000000000000000000000000

levelc-2.png
172 57072
