00000000000000000000000000000000
00001000001000000001000000000000
00001000001000000001000000000000
00001000001000000000000000000000
00001000004000000000000000000000
00001000001000000000000000000000
00001111112000000000000000000000
00001000001000000001000000000000
00001000003000000001000000000000
00001000001000000001000000000000
00001000001000000001000000000000
00001000001000000001000000000000
00001000001000000001000000000000
00001000001000000001000000000000
00000000001000000000000000000000
00000000000000000000000000000000
00000000000000000000000000000000
00000000000000000000000000000000

levelc-6.png
3
