000000000000000
000000000000000
000011100000000
000011100000000
000011100000000
000011100000000
000011100000000
000011400000000
000011100000000
000011100000000
000011111111000
000011123111000
000011111111000
000000000000000
000000000000000

levelc-4.png
None