00000000000000000000000000000000
00000000000000111000000000000000
00000000001111221000000000000000
00000000001000011101110000000000
00000000001121212100210000000000
00000000002101210111110000000000
00000000001101110110000000000000
00000000001121020100000000000000
00000000001001111100000000000000
00000000001000001110000000000000
00000000011103041110000000000000
00000000011113001113000000000000
00000000001111333333000000000000
00000000000003000000000000000000
00000000000000000000000000000000
00000000000000000000000000000000
00000000000000000000000000000000
00000000000000000000000000000000

levelc-3.png
483 113616
