00000000000
01100001100
01100011000
01100110000
01101100000
02311000000
01411000000
01101100000
01100110000
01100011000
00000000000

level1-1.png
21