00000000000
01111111110
01111111110
00001110000
00001210000
00001410000
00001310000
00001110000
01111111110
01111111110
00000000000

level1-1.png
21