00000000000
01110000000
01110000000
01110000000
01110000000
01110000000
01110000000
01310000000
01421111110
01111111110
00000000000

level1-1.png
21